111111111111111111111111111111111111111111111
1E11111100C11000000000000111111111111111111P1
101111100011110000010011011111111111111111101
101111110001100001000010000000000000000111101
101111111100000000010000001000000100000111101
101111111110000000000000000000000000000111101
10111111111110111000000C000100000000000111101
101111111000000010010000000000100000000111101
101111110010000000000000000000000000000111101
111111110000000000001011110000000000000111101
10000001000000010000001C010001000000000111101
100010000010000100000011000000000000000111101
100100000000000111000000000000000000000111101
1C100000000100000000000C000000000000000111101
11C0000000010000000000000000100010000001111C1
100000000000000000000000000000000000000000001
100000010000010001000000000000000000000000001
100000000000000000000000010000000000000000001
100000000100000000000010000100000100000000001
100000000000010000000000000000000000000000001
1000001000000000000100000C0000000000000000001
100000000000000000000000000000000000000000001
111111111111111111111111111111111111111111111