1111111
1E10001
111P011
10000C1
1000001
1000001
1000001
1000001
1000001
1111111