1111111
1E10001
101P011
10000C1
1000001
1000001
1000001
1110001
1C10001
1111111